


F 215,180,120
C 155,48,79


NO texture/redbrick.xpm
SO texture/mossy.xpm
WE texture/wood.xpm
EA texture/greystone.xpm
S texture/barrel.xpm





R 800 600


 11111111111111
10000000000001
10000000000000111111111
11111000000000000000001                11
     1111000000000011111111          111011
     10000000000111                  1000011
      1000000000011       111111     1000001
       1111111110001111111002011111111110111      
        1111111111000000000000000000000001111
                  11111100000000000000111111
             1111111111000000000000001
    1111111110000000200000011111111111
    100000000000000E000000001
    1000000200000000000000001
    1000000111111111111110011          111
    10000001             11  1111     10001
    1000000011111111        100001     111
    10000000000000011111111101111
     11111111111111000000000001       11
                   11111111111  11111100111
                                      11
                         111      11
                        1000111111001
                        1000000001111
                        100111111
                        111